 +------+                                                                      
 |......|                                                                      
 |......+---+                                                                  
 |..........#####################                                              
 +---#------+      # # # #     #                                               
     #           ### # # #     #                                               
     ########    # #######     #                                               
            #    ### # # #     #                                               
  +----------------#-#-#-#--------+                +-------+          +-+      
  |...............................##################.......############.|      
  |...+-------+...................|  #             |.......+----+     +.+      
  |...|       |..............+----+  #  ####       |............|     |.|      
  |...|       |..............|       ####  # +-----+...+---+....|   +-+.+----+ 
  |...+-------+.........+----+             # |.........|   |....|   |........| 
  |.....................|                  # |.........+---+....|   |........| 
  |................+----+ +-------------+  # |..................|   +--------+ 
  |................|      |.............|  # +------------------+              
  +----#---------#-+      |.............####                                   
       #         #   +----+.............|  ####                                
       ###########   |..................|  #  #                                
       #     #       |..................#######                                
       #     #########..................|                                      
       #######       |..................|                                      
                     +------------------+                                      
